#########################################
#                                       #
# ####### ##### ####### ##### ####### ###
#   #         #   #         #       #   #
# ### ##### ####### ### ### ##### ### ###
#   #   #     #       #   #     #   #   #
# ##### ### ### ####### ######### #######
#   #     #   #       #     #           #
##### ### ### ##### ######### ####### ###
#       #   #     #       #       #     #
####### ##### ### ### ### ##### ##### ###
#           #   #   #   #     #     #   #
### ############# ### ### ####### ### ###
#           #       #   #   #       #   #
# ##### ##### ####### ### ##### ####### #
#   #     #         #   #   #         # #
####### ### ##### ##### ### ### ### ### #
#         #   #       #   #   #   #   # #
# ####### ### ##### ####### ####### ### #
#   #       #     #     #         #   # #
# ### ### ####### ### ### ##### ### #####
#   #   #       #   #   #   #     #     #
# ### ######### ##### ### ### ####### ###
#   #       #     #     #   #     #     #
# ####### ### ##### ####### ######### ###
#   #       #     #     #           #   #
# ##### ### ### ################### ### #
#     #   #   #   #                   # #
# ################# ### ### ### ####### #
#                 #   #   #   #       # #
# ### ### ### ### ####### ##### ####### #
#   #   #   #   #     #     #         # #
##### ##### ### ##### ### ### ####### ###
#       #     #     #   #   #       #   #
# ### ##### ######### ##### ####### #####
#   #   #           #   #         #     #
### ####### ### ### ### ### ####### #####
#     #       #   #   #   #   #         #
# ##### ##### ### ########### ### ### ###
#     #     #   #   #           #   #   #
# ### ### ### ### ### ####### ### ### ###
#   #   #   #   #   #   #       #   #   #
#########################################
