#########################################
#                                       #
########### ####### ####### ### ##### ###
#                 #     #     #     #   #
# ### ### ##### ### ######### ##### ### #
#   #   #   #     #   #           #   # #
### ### ### ################### ##### ###
#     #   #               #         #   #
########### ### ##### ### ######### #####
#             #     #   #     #         #
# ### ##### ### ##### ######### ### #####
#   #   #     #     #   #         #     #
#########################################
