#########
#   # # #
### #####
#   # # #
# #######
# # # # #
# #######
# # # # #
# #######
# # # # #
# # #####
# # # # #
# # #####
# # # # #
# # #####
#       #
#########
